;
; Название проекта

Модель MOBOT_DU на полигоне

; Размер поля self.DIM_X self.DIM_Y
; Если сопоставлять с реальным миром, то 1 клетка = 10 см.
; В системе Gazebo натуральный размер определяется значением ключа --ration для утилиты map2world (--ratio 10)
;
200 200

; Ширина и высота окна отображения поля self.MAX_SCR_X self.MAX_SCR_Y
; *** Для конвертера в Gazebo игнорируется
600 600

; Флаг режима топологии тора self.UseTorusRegime
False

; Частота процесса self.Rate 100
; *** Для конвертера в Gazebo игнорируется
50

; Описание элементов
; *** Для конвертера в Gazebo игнорируется
!["#", "gdic.LEVEL_GROUND", "1", False]

; ArUco-маркеры
; *** Для конвертера в Gazebo игнорируется
!["123456", "gdic.LEVEL_COLOR", "", True]

; Множители
; *** Для конвертера в Gazebo игнорируется
1 1

; Поле
; Описание элементов
; 0-9, a-f - ArUco-объекты
; # - препятствие
; Q - куб
; R - цилиндр
; S - пятно

***************************************************
*.................................................*
*.................................................*
*.................................................*
*.................................................*
*.................................................*
*.................................................*
*.................................................*
*.................................................*
*.................................0...............*
*...1..............#..............................*
*..................#...#..........................*
*..................#####......23..................*
*.................................................*
*.................................................*
*.................................................*
*...........................#...45................*
*.................................................*
*...........................#.....................*
*.................................................*
*....................^............................*
*.................................................*
*.................................................*
*.................................................*
*.................................................*
*.................................................*
*.................................................*
*.................................................*
*.................................................*
*.................................................*
*.................................................*
*.................................................*
*.................................................*
*.................................................*
*.................................................*
*.................................................*
*.................................................*
*.................................................*
*.................................................*
*.................................................*
*.................................................*
*.................................................*
*.................................................*
*.................................................*
*.................................................*
*.................................................*
*.................................................*
*.................................................*
***************************************************
